#domain
hospital
#levelname
BFSfriendly
#colors
blue: 0,1,2
#initial
++++++++++++++++++++
+    2    ++++++   +
+ ++++++++      1+++
+ ++++++++ +++++++++
+         0  +     +
++++++ +++ +++++++ +
++   + +++ +++++++ +
++ +++ +++ +++++++ +
++     +++         +
++++++++++++++++++++
#goal
++++++++++++++++++++
+        2++++++  1+
+ ++++++++       +++
+ ++++++++ +++++++++
+           0+     +
++++++ +++ +++++++ +
++   + +++ +++++++ +
++ +++ +++ +++++++ +
++     +++         +
++++++++++++++++++++
#end