#domain
hospital
#levelname
Bottleneck
#colors
blue: 0, A, B, C
#initial
++++++++++++++++++++++++++++++++++++++
+++++++++++++++++++ ++++++++++++++++++
+++++++++++++++++++ ++++++++++++++++++
+++++++++++++++++++ ++++++++++++++++++
+    ABC    +++++++ ++++++           +
+           +++++++ ++++++           +
+A    A     +++++++ ++++++           +
+B    B    0                         +
+C    C     +++++++ ++++++           +
+           +++++++ ++++++           +
+    ABC    +++++++ ++++++           +
+++++++++++++++++++ ++++++++++++++++++
+++++++++++++++++++ ++++++++++++++++++
+++++++++++++++++++ ++++++++++++++++++
++++++++++++++++++++++++++++++++++++++
#goal
++++++++++++++++++++++++++++++++++++++
+++++++++++++++++++C++++++++++++++++++
+++++++++++++++++++B++++++++++++++++++
+++++++++++++++++++A++++++++++++++++++
+           +++++++ ++++++           +
+           +++++++ ++++++           +
+           +++++++ ++++++          A+
+                 ABC               B+
+           +++++++ ++++++          C+
+           +++++++ ++++++           +
+           +++++++ ++++++           +
+++++++++++++++++++A++++++++++++++++++
+++++++++++++++++++B++++++++++++++++++
+++++++++++++++++++C++++++++++++++++++
++++++++++++++++++++++++++++++++++++++
#end
