#domain
hospital
#levelname
hop
#colors
blue: 0, 1, 2, 3
#initial
++++++++++++++++
+              +
+       ++     +
+       ++     +
+       ++     +
+       ++     +
+       ++     +
+       ++0    +
+       ++1    +
+       ++2    +
+       ++3    +
++++++++++++++++
#goal
++++++++++++++++
+              +
+       ++     +
+       ++     +
+       ++     +
+       ++     +
+       ++     +
+       ++     +
+       ++     +
+       ++     +
+   0123++     +
++++++++++++++++
#end