#domain
hospital
#levelname
MAsimple1
#colors
red: 0, 1, 2, A
#initial

++++++++++++++++++++++++++++
++++++ +++++++ ++++++ ++++++
+AAA 0       1      2      +
++++++++++++++++++++++++++++
#goal
++++++++++++++++++++++++++++
++++++ +++++++ ++++++ ++++++
+    0       1      2   AAA+
++++++++++++++++++++++++++++
#end
