#domain
hospital
#levelname
MAsimple2
#colors
blue: 0, 1
#initial
++++++++++++
+       0+ +
+ ++++++++ +
+          +
+ ++++++++ +
+ +1       +
++++++++++++
#goal
++++++++++++
+        +0+
+ ++++++++ +
+          +
+ ++++++++ +
+1+        +
++++++++++++
#end
