#domain
hospital
#levelname
MAsimple2
#colors
red: 0, A
green: 1, B
#initial
++++++++++++
+       0+ +
+ ++++++++A+
+          +
+B++++++++ +
+ +1       +
++++++++++++
#goal
++++++++++++
+       0+A+
+ ++++++++ +
+          +
+ ++++++++ +
+B+1       +
++++++++++++
#end
