#domain
hospital
#levelname
MAsimple2
#colors
red: 0, A
green: 1, B
#initial
++++++++++++
+     BA0+ +
+ ++++++++ +
+          +
+ ++++++++ +
+ +1       +
++++++++++++
#goal
++++++++++++
+        +A+
+ ++++++++ +
+          +
+ ++++++++ +
+B+        +
++++++++++++
#end
