#domain
hospital
#levelname
SAD3
#colors
blue: 0, A
#initial
+++++++++++++++++++
+0AAA             +
+AAAA           +++
+ AAA             +
+              ++A+
+               + +
+++++++++++++++++++
#goal
+++++++++++++++++++
+                 +
+               +++
+                 +
+              ++ +
+               +A+
+++++++++++++++++++
#end